The provided Node.js code is responsible for exporting various modules and entities for a MongoDB driver by referencing and exporting components, classes, enumerations, errors, and events from different modules. These exports expose specific functionalities and structures to be used elsewhere in an application while keeping them organized and accessible from a single entry point, typically through an index file.

Here's a breakdown of the code:
- It begins with defining TypeScript settings indicating it's a module exporting functionality using `exports.__esModule`.
- It imports various modules using `require` from different internal files and directories within a project structure.
- It then uses `Object.defineProperty` to export entities (i.e., classes, items, events) from these modules, specifying properties like `enumerable` and providing a getter function to return the item from the module.
- It organizes the exports into logical sections like classes, errors, events, enums, etc., enabling structured access to the MongoDB driver functionalities.

Here is a possible rewrite of the code:

```javascript
"use strict";

// Exporting classes, error types, event types, and other functionality from various modules
Object.defineProperty(exports, "__esModule", { value: true });

// Exporting specific functionalities
const adminModule = require("./admin");
const bulkOrdered = require("./bulk/ordered");
const bulkUnordered = require("./bulk/unordered");
const changeStreamModule = require("./change_stream");
const collectionModule = require("./collection");
const abstractCursorModule = require("./cursor/abstract_cursor");
const aggregationCursorModule = require("./cursor/aggregation_cursor");
const findCursorModule = require("./cursor/find_cursor");
const listCollectionsCursorModule = require("./cursor/list_collections_cursor");
const listIndexesCursorModule = require("./cursor/list_indexes_cursor");
const dbModule = require("./db");
const gridfsModule = require("./gridfs");
const gridfsDownloadModule = require("./gridfs/download");
const gridfsUploadModule = require("./gridfs/upload");
const mongoClientModule = require("./mongo_client");
const mongoTypesModule = require("./mongo_types");
const sessionsModule = require("./sessions");
const bsonModule = require("./bson");
const bulkCommonModule = require("./bulk/common");
const clientEncryptionModule = require("./client-side-encryption/client_encryption");
const changeStreamCursorModule = require("./cursor/change_stream_cursor");
const errorModule = require("./error");
const resourceManagementModule = require("./resource_management");
const autoEncrypterModule = require("./client-side-encryption/auto_encrypter");
const gssapiModule = require("./cmap/auth/gssapi");
const providersModule = require("./cmap/auth/providers");
const compressionModule = require("./cmap/wire_protocol/compression");
const explainModule = require("./explain");
const findAndModifyModule = require("./operations/find_and_modify");
const profilingLevelModule = require("./operations/set_profiling_level");
const readConcernModule = require("./read_concern");
const readPreferenceModule = require("./read_preference");
const commonSdamModule = require("./sdam/common");
const writeConcernModule = require("./write_concern");
const commandMonitoringEventsModule = require("./cmap/command_monitoring_events");
const connectionPoolEventsModule = require("./cmap/connection_pool_events");
const sdamEventsModule = require("./sdam/events");
const serverSelectionEventsModule = require("./sdam/server_selection_events");
const srvPollingModule = require("./sdam/srv_polling");
const clientSideEncryptionErrorsModule = require("./client-side-encryption/errors");
const mongoClientAuthProvidersModule = require("./mongo_client_auth_providers");

// Defining exports using Object.defineProperty to ensure properties are set as enumerable and using getters

// Example Exports for illustrative purposes
Object.defineProperty(exports, "Admin", { enumerable: true, get: function () { return adminModule.Admin; } });
Object.defineProperty(exports, "OrderedBulkOperation", { enumerable: true, get: function () { return bulkOrdered.OrderedBulkOperation; } });
Object.defineProperty(exports, "UnorderedBulkOperation", { enumerable: true, get: function () { return bulkUnordered.UnorderedBulkOperation; } });
Object.defineProperty(exports, "ChangeStream", { enumerable: true, get: function () { return changeStreamModule.ChangeStream; } });
Object.defineProperty(exports, "Collection", { enumerable: true, get: function () { return collectionModule.Collection; } });
// Continue similarly for all other needed exports

// Note: The above is a simplified template to illustrate the structure of the rewrite
// Use the same pattern for all modules being exported to maintain cohesiveness and ensure all functionality is provided
```