The Node.js code is a module that aggregates various validation and conversion functions. It imports functions from different files located in a `lib` directory and organizes them into a single `validator` object. This object contains methods for transforming data types (e.g., `toDate`, `toFloat`), validating input against a variety of formats (e.g., `isEmail`, `isURL`, `isCreditCard`), and checking the content (e.g., `equals`, `contains`, `matches`). The module exports this `validator` object, allowing other parts of an application to utilize these methods for data validation and manipulation.

Here's a possible rewrite of the code with a similar structure and functionality:

```javascript
"use strict";

const _typeof = (o) => {
  return typeof o === "object" && o !== null
    ? Symbol.iterator in Object(o)
      ? "symbol"
      : "object"
    : typeof o;
};

Object.defineProperty(exports, "__esModule", {
  value: true,
});

const importModule = (moduleName) => require(`./lib/${moduleName}`).default;
const importWildcard = (moduleName) => require(`./lib/${moduleName}`);

const validator = {
  version: '13.12.0',
  toDate: importModule('toDate'),
  toFloat: importModule('toFloat'),
  toInt: importModule('toInt'),
  toBoolean: importModule('toBoolean'),
  equals: importModule('equals'),
  contains: importModule('contains'),
  matches: importModule('matches'),
  isEmail: importModule('isEmail'),
  isURL: importModule('isURL'),
  isMACAddress: importModule('isMACAddress'),
  isIP: importModule('isIP'),
  isIPRange: importModule('isIPRange'),
  isFQDN: importModule('isFQDN'),
  isBoolean: importModule('isBoolean'),
  isIBAN: importWildcard('isIBAN').default,
  isBIC: importModule('isBIC'),
  isAbaRouting: importModule('isAbaRouting'),
  isAlpha: importWildcard('isAlpha').default,
  isAlphaLocales: importWildcard('isAlpha').locales,
  isAlphanumeric: importWildcard('isAlphanumeric').default,
  isAlphanumericLocales: importWildcard('isAlphanumeric').locales,
  isNumeric: importModule('isNumeric'),
  isPassportNumber: importModule('isPassportNumber'),
  isPort: importModule('isPort'),
  isLowercase: importModule('isLowercase'),
  isUppercase: importModule('isUppercase'),
  isAscii: importModule('isAscii'),
  isFullWidth: importModule('isFullWidth'),
  isHalfWidth: importModule('isHalfWidth'),
  isVariableWidth: importModule('isVariableWidth'),
  isMultibyte: importModule('isMultibyte'),
  isSemVer: importModule('isSemVer'),
  isSurrogatePair: importModule('isSurrogatePair'),
  isInt: importModule('isInt'),
  isIMEI: importModule('isIMEI'),
  isFloat: importWildcard('isFloat').default,
  isFloatLocales: importWildcard('isFloat').locales,
  isDecimal: importModule('isDecimal'),
  isHexadecimal: importModule('isHexadecimal'),
  isOctal: importModule('isOctal'),
  isDivisibleBy: importModule('isDivisibleBy'),
  isHexColor: importModule('isHexColor'),
  isRgbColor: importModule('isRgbColor'),
  isHSL: importModule('isHSL'),
  isISRC: importModule('isISRC'),
  isMD5: importModule('isMD5'),
  isHash: importModule('isHash'),
  isJWT: importModule('isJWT'),
  isJSON: importModule('isJSON'),
  isEmpty: importModule('isEmpty'),
  isLength: importModule('isLength'),
  isLocale: importModule('isLocale'),
  isByteLength: importModule('isByteLength'),
  isUUID: importModule('isUUID'),
  isMongoId: importModule('isMongoId'),
  isAfter: importModule('isAfter'),
  isBefore: importModule('isBefore'),
  isIn: importModule('isIn'),
  isLuhnNumber: importModule('isLuhnNumber'),
  isCreditCard: importModule('isCreditCard'),
  isIdentityCard: importModule('isIdentityCard'),
  isEAN: importModule('isEAN'),
  isISIN: importModule('isISIN'),
  isISBN: importModule('isISBN'),
  isISSN: importModule('isISSN'),
  isMobilePhone: importWildcard('isMobilePhone').default,
  isMobilePhoneLocales: importWildcard('isMobilePhone').locales,
  isPostalCode: importWildcard('isPostalCode').default,
  isPostalCodeLocales: importWildcard('isPostalCode').locales,
  isEthereumAddress: importModule('isEthereumAddress'),
  isCurrency: importModule('isCurrency'),
  isBtcAddress: importModule('isBtcAddress'),
  isISO6346: importWildcard('isISO6346').isISO6346,
  isFreightContainerID: importWildcard('isISO6346').isFreightContainerID,
  isISO6391: importModule('isISO6391'),
  isISO8601: importModule('isISO8601'),
  isRFC3339: importModule('isRFC3339'),
  isISO31661Alpha2: importModule('isISO31661Alpha2'),
  isISO31661Alpha3: importModule('isISO31661Alpha3'),
  isISO4217: importModule('isISO4217'),
  isBase32: importModule('isBase32'),
  isBase58: importModule('isBase58'),
  isBase64: importModule('isBase64'),
  isDataURI: importModule('isDataURI'),
  isMagnetURI: importModule('isMagnetURI'),
  isMailtoURI: importModule('isMailtoURI'),
  isMimeType: importModule('isMimeType'),
  isLatLong: importModule('isLatLong'),
  ltrim: importModule('ltrim'),
  rtrim: importModule('rtrim'),
  trim: importModule('trim'),
  escape: importModule('escape'),
  unescape: importModule('unescape'),
  stripLow: importModule('stripLow'),
  whitelist: importModule('whitelist'),
  blacklist: importModule('blacklist'),
  isWhitelisted: importModule('isWhitelisted'),
  normalizeEmail: importModule('normalizeEmail'),
  toString,
  isSlug: importModule('isSlug'),
  isStrongPassword: importModule('isStrongPassword'),
  isTaxID: importModule('isTaxID'),
  isDate: importModule('isDate'),
  isTime: importModule('isTime'),
  isLicensePlate: importModule('isLicensePlate'),
  isVAT: importModule('isVAT'),
  ibanLocales: importWildcard('isIBAN').locales,
};

exports.default = validator;
module.exports = validator;
```

This rewritten code maintains the structure and functionality of the original code while simplifying and demonstrating the importing process.