The given Node.js code is a module exporting various React components and utility functions from the @mui/material library. This module aims to re-export components and utilities so they can be accessed elsewhere in a project. Here's a breakdown of its functionality:

1. **Imports**: The code uses `require` statements to import helper functions from different files, such as Babel's interop helpers and modules from `@mui/material`.

2. **Exports Management**: The object `exports` is set with properties named after components or utilities that can be used in other files. These exported properties can be accessed selectively by importing files from other modules like Accordion, Alert, Button, etc.

3. **Dynamic Export Statements**: The code sets up dynamic exports using `Object.defineProperty`, which allows each component or utility to be exported with a getter function that retrieves the default export from each respective module.

4. **Webpack Considerations**: The keys returned are using condition checks if already defined, to handle situations where multiple scripts could interact due to circular dependencies or similar issues in module bundling environments.

5. **Version Management**: The code also exports version information from the `version` module as part of the exports, allowing package consumers to know which version they are using.

The code exports a comprehensive library of UI components and the necessary utilities to build React applications using Material-UI. Here's a possible rewrite of the code:

```javascript
"use strict";

const interopRequireDefault = require("@babel/runtime/helpers/interopRequireDefault").default;
const interopRequireWildcard = require("@babel/runtime/helpers/interopRequireWildcard").default;

Object.defineProperty(exports, "__esModule", { value: true });

const componentsMap = {
  colors: './colors',
  Accordion: './Accordion',
  AccordionActions: './AccordionActions',
  AccordionDetails: './AccordionDetails',
  AccordionSummary: './AccordionSummary',
  Alert: './Alert',
  AlertTitle: './AlertTitle',
  AppBar: './AppBar',
  Autocomplete: './Autocomplete',
  Avatar: './Avatar',
  AvatarGroup: './AvatarGroup',
  Backdrop: './Backdrop',
  Badge: './Badge',
  BottomNavigation: './BottomNavigation',
  BottomNavigationAction: './BottomNavigationAction',
  Box: './Box',
  Breadcrumbs: './Breadcrumbs',
  Button: './Button',
  ButtonBase: './ButtonBase',
  ButtonGroup: './ButtonGroup',
  Card: './Card',
  CardActionArea: './CardActionArea',
  CardActions: './CardActions',
  CardContent: './CardContent',
  CardHeader: './CardHeader',
  CardMedia: './CardMedia',
  Checkbox: './Checkbox',
  Chip: './Chip',
  CircularProgress: './CircularProgress',
  ClickAwayListener: './ClickAwayListener',
  Collapse: './Collapse',
  Container: './Container',
  CssBaseline: './CssBaseline',
  darkScrollbar: './darkScrollbar',
  Dialog: './Dialog',
  DialogActions: './DialogActions',
  DialogContent: './DialogContent',
  DialogContentText: './DialogContentText',
  DialogTitle: './DialogTitle',
  Divider: './Divider',
  Drawer: './Drawer',
  Fab: './Fab',
  Fade: './Fade',
  FilledInput: './FilledInput',
  FormControl: './FormControl',
  FormControlLabel: './FormControlLabel',
  FormGroup: './FormGroup',
  FormHelperText: './FormHelperText',
  FormLabel: './FormLabel',
  Grid: './Grid',
  Grid2: './Grid2',
  Grow: './Grow',
  Hidden: './Hidden',
  Icon: './Icon',
  IconButton: './IconButton',
  ImageList: './ImageList',
  ImageListItem: './ImageListItem',
  ImageListItemBar: './ImageListItemBar',
  Input: './Input',
  InputAdornment: './InputAdornment',
  InputBase: './InputBase',
  InputLabel: './InputLabel',
  LinearProgress: './LinearProgress',
  Link: './Link',
  List: './List',
  ListItem: './ListItem',
  ListItemAvatar: './ListItemAvatar',
  ListItemButton: './ListItemButton',
  ListItemIcon: './ListItemIcon',
  ListItemSecondaryAction: './ListItemSecondaryAction',
  ListItemText: './ListItemText',
  ListSubheader: './ListSubheader',
  Menu: './Menu',
  MenuItem: './MenuItem',
  MenuList: './MenuList',
  MobileStepper: './MobileStepper',
  Modal: './Modal',
  NativeSelect: './NativeSelect',
  NoSsr: './NoSsr',
  OutlinedInput: './OutlinedInput',
  Pagination: './Pagination',
  PaginationItem: './PaginationItem',
  Paper: './Paper',
  Popover: './Popover',
  Popper: './Popper',
  Portal: './Portal',
  Radio: './Radio',
  RadioGroup: './RadioGroup',
  Rating: './Rating',
  ScopedCssBaseline: './ScopedCssBaseline',
  Select: './Select',
  Skeleton: './Skeleton',
  Slide: './Slide',
  Slider: './Slider',
  Snackbar: './Snackbar',
  SnackbarContent: './SnackbarContent',
  SpeedDial: './SpeedDial',
  SpeedDialAction: './SpeedDialAction',
  SpeedDialIcon: './SpeedDialIcon',
  Stack: './Stack',
  Step: './Step',
  StepButton: './StepButton',
  StepConnector: './StepConnector',
  StepContent: './StepContent',
  StepIcon: './StepIcon',
  StepLabel: './StepLabel',
  Stepper: './Stepper',
  SvgIcon: './SvgIcon',
  SwipeableDrawer: './SwipeableDrawer',
  Switch: './Switch',
  Tab: './Tab',
  Table: './Table',
  TableBody: './TableBody',
  TableCell: './TableCell',
  TableContainer: './TableContainer',
  TableFooter: './TableFooter',
  TableHead: './TableHead',
  TablePagination: './TablePagination',
  TableRow: './TableRow',
  TableSortLabel: './TableSortLabel',
  Tabs: './Tabs',
  TabScrollButton: './TabScrollButton',
  TextField: './TextField',
  TextareaAutosize: './TextareaAutosize',
  ToggleButton: './ToggleButton',
  ToggleButtonGroup: './ToggleButtonGroup',
  Toolbar: './Toolbar',
  Tooltip: './Tooltip',
  Typography: './Typography',
  useMediaQuery: './useMediaQuery',
  usePagination: './usePagination',
  useScrollTrigger: './useScrollTrigger',
  Zoom: './Zoom',
  useAutocomplete: './useAutocomplete',
  GlobalStyles: './GlobalStyles',
  unstable_composeClasses: '@mui/utils',
  generateUtilityClass: './generateUtilityClass',
  generateUtilityClasses: './generateUtilityClasses',
  Unstable_TrapFocus: './Unstable_TrapFocus',
  version: './version'
};

// Import and define properties for each component
for (const [exportName, path] of Object.entries(componentsMap)) {
  Object.defineProperty(exports, exportName, {
    enumerable: true,
    get: function() {
      // Handle wildcard imports separately
      const module = exportName === "colors" || exportName === "GlobalStyles" ? interopRequireWildcard(require(path)) : interopRequireDefault(require(path)).default;
      return module;
    }
  });
}
```
